32 11
65 65
7   7   10  7   7   7   7   7   11  7   7   12  7   7   7   7   7   7   7   7   13  7   14  7   7   7   15  7   16  7   17  7
39  8   8   8   8   8   8   8   8   8   8   8   8   8   8   8   8   8   8   8   8   8   8   8   8   8   8   8   8   8   8   40
39  8   8   8   8   8   8   8   8   8   8   8   8   8   8   8   8   8   8   8   8   8   8   8   8   8   8   8   8   8   8   40
7   7   18  7   7   8   7   8   7   7   7   21  7   4   4   4   4   4   7   7   22  7   23  7   8   7   25  7   26  7   27  7
9   9   9   9   7   19  7   20  7   9   9   9   7   4   4   4   4   4   41   9   9   9   9   7   24  7   9   9   9   9   9   9
9   9   9   9   9   9   9   9   9   9   9   9   7   4   4   4   4   4   41   9   9   9   9   9   9   9   9   9   9   9   9   9
9   9   9   9   9   9   9   9   9   9   9   9   7   4   4   4   4   4   41   9   9   9   9   9   9   9   9   9   9   9   9   9
7   28  7   7   7   7   29  7   30  7   7   31  7   4   4   4   4   4   7   32  7   7   7   7   33  7   34  7   7   7   35  7
7   8   8   8   8   8   8   8   8   8   8   8   8   8   8   8   8   8   8   8   8   8   8   8   8   8   8   8   8   8   8   40
7   8   8   8   36  36  37  8   8   8   8   8   8   8   8   8   8   8   8   8   8   8   8   8   8   8   8   8   8   8   8   40
7   38  38  7   7   7   7   7   7   7   7   7   7   7   38  38  38  7   7   7   7   7   7   7   7   7   7   7   7   7   7   7