17 32
9 15
9   9   9  9   9   9   9   9   9  9   9   9   9   7   181 7   9 
9   9   9  9   9   9   7   178 7  9   9   9   9   163 4   7   9
9   9   9  9   9   9   7   4   7  179 7   180 7   41  4   7   9
9   177 9  9   9   9   7   4   4  4   4   4   4   4   4   7   9
7   4   7  7   7   7   7   4   4  4   4   4   4   4   4   7   9
7   4   4  4   4   4   4   4   7  174 175 176 7   4   4   7   9
7   4   4  4   4   4   4   4   7  9   9   9   7   4   4   4   167
126 4   4  7   7   7   4   4   7  9   9   9   7   4   4   7   9
125 4   4  7   9   7   4   4   7  9   9   9   162 4   4   166 9
124 4   4  141 9   155 4   4   7  9   9   9   7   4   4   7   9
123 4   4  140 9   154 4   4   7  9   9   9   7   4   4   7   9
122 4   4  139 9   153 4   4   7  9   9   9   7   4   4   165 9
121 4   4  138 9   152 4   4   7  9   9   161 4   4   4   7   9
120 4   4  137 9   151 4   4   7  9   9   9   7   4   4   7   9
119 4   4  136 9   150 4   4   7  9   9   9   7   4   4   164 9
7   4   4  135 9   149 4   4   7  9   9   160 4   4   4   7   228
118 4   4  134 9   148 4   4   7  9   9   9   7   4   4   7   59
117 4   4  133 9   7   4   4   7  9   9   9   7   4   4   7   59
116 4   4  7   182 7   4   4   7  53  53  53  7   4   4   7   59
7   4   4  4   4   4   4   4   4  4   4   4   4   4   4   7   59
7   4   4  4   4   4   4   4   4  4   4   4   4   4   4   4   4
115 4   4  4   4   4   4   4   4  4   4   4   4   4   4   4   4
114 4   4  7   7   7   4   4   7  7   7   7   4   4   4   4   4
7   4   4  132 9   147 4   4   7  9   9   7   4   4   4   9   59
113 4   4  131 9   146 4   4   7  9   159 4   4   4   4   9   59
112 4   4  130 9   145 4   4   7  9   9   7   4   4   7   9   59
111 4   4  129 9   144 4   4   7  9   158 4   4   4   7   9   61
110 4   4  128 9   143 4   4   7  9   9   157 4   4   7   9   9
109 4   4  127 9   142 4   4   7  9   9   156 4   4   7   9   9
108 4   4  7   7   7   4   4   7  183 184 7   4   4   7   9   9
107 4   4  4   4   4   4   4   4  4   4   4   4   4   7   9   9
7   168 7  7   169 7   170 171 7  172 7   173 7   7   7   9   9