17 32
9 15
7   99 7  7 100  7  7 101 7  7 102  7  7  7  7  7  7 
73  4  4  4  4   4  4  4  4  4  4  98 9  9  9  9   7
7   4  4  7  7   7  7  7  7  4  4  7  9  9  9  9   7
7   4  4  80 9   9  9  9  89 4  4  97 9  9  9  9   7
72  4  4  7  9   9  9  9  7  4  4  7  9  9  9  9   7
7   4  4  79 9   9  9  9  41 4  4  96 9  9  9  9   7
71  4  4  7  9   9  9  9  88 4  4  7  9  9  9  9   7
7   4  4  78 9   9  9  9  7  4  4  95 9  9  9  9   7
70  4  4  7  9   9  9  9  87 4  4  7  9  9  9  9   7
7   4  4  77 9   9  9  9  7  4  4  94 9  9  9  9   7
69  4  4  7  9   9  9  9  86 4  4  7  9  9  9  9   7
7   4  4  76 9   9  9  9  7  4  4  7  9  9  9  9   7
68  4  4  7  9   9  9  9  85 4  4  93 9  9  9  9   7
7   4  4  75 9   9  9  9  7  4  4  7  9  9  9  9   7
67  4  4  74 9   52 52 52 7  4  4  4  60 9  9  9   7
7   4  4  7  7   4  4  4  4  4  4  4  59 9  9  9   7
66  4  4  4  4   4  4  4  4  4  4  4  59 9  9  9   7
65  4  4  7  7   7  7  7  7  4  4  4  59 9  9  9   7
7   4  4  7  9   9  9  84 4  4  4  4  59 9  9  9   7
7   4  4  7  9   9  9  7  7  4  4  4  4  7  7  7   7
64  4  4  7  9   9  9  83 4  4  4  4  4  4  4  4   7
7   4  4  7  9   9  9  9  7  4  4  4  4  4  4  4   7
7   4  4  7  9   9  9  9  7  4  4  4  4  4  4  4   7
7   4  4  7  9   9  9  9  7  4  4  7  7  7  4  4   7
7   4  4  7  9   9  9  9  7  4  4  92 9  7  4  4   7
63  4  4  7  9   9  9  9  82 4  4  7  9  7  4  4   7
7   4  4  7  9   9  9  9  7  4  4  7  9  7  44 55  7
7   4  4  7  9   9  9  9  81 4  4  7  9  7  44 55  7
62  4  4  7  7   7  7  7  7  4  4  91 9  7  45 56  7
7   4  4  4  4   4  4  4  4  4  4  7  9  7  9  9   7
7   4  4  4  4   4  4  4  4  4  4  4  90 7  9  9   7
7   7  7 103 7   7 104 7 105 7 106  7  7  7  7  7   7