17 32
9 15
9   9  9  9  9  9  9  9  9  9  9  9  9  7  6  7   9 
9   9  9  9  9  9  7  6  7  9  9  9  9  6  4  7   9
9   9  9  9  9  9  7  4  7  6  7  6  7  41 4  7   9
9   6  9  9  9  9  7  4  4  4  4  4  4  4  4  7   9
7   4  7  7  7  7  7  4  4  4  4  4  4  4  4  7   9
7   4  4  4  4  4  4  4  7  6  6  6  7  4  4  7   9
7   4  4  4  4  4  4  4  7  9  9  9  7  4  4  4   6
6   4  4  7  7  7  4  4  7  9  9  9  7  4  4  7   9
6   4  4  7  9  7  4  4  7  9  9  9  6  4  4  6   9
6   4  4  6  9  6  4  4  7  9  9  9  7  4  4  7   9
6   4  4  6  9  6  4  4  7  9  9  9  7  4  4  7   9
6   4  4  6  9  6  4  4  7  9  9  9  7  4  4  6   9
6   4  4  6  9  6  4  4  7  9  9  6  4  4  4  7   9
6   4  4  6  9  6  4  4  7  9  9  9  7  4  4  7   9
6   4  4  6  9  6  4  4  7  9  9  9  7  4  4  6   9
7   4  4  6  9  6  4  4  7  9  9  6  4  4  4  7   59
6   4  4  6  9  6  4  4  7  9  9  9  7  4  4  7   59
6   4  4  6  9  7  4  4  7  9  9  9  7  4  4  7   59
6   4  4  7  6  7  4  4  7  53 53 53 7  4  4  7   59
7   4  4  4  4  4  4  4  4  4  4  4  4  4  4  7   59
7   4  4  4  4  4  4  4  4  4  4  4  4  4  4  4   4
6   4  4  4  4  4  4  4  4  4  4  4  4  4  4  4   4
6   4  4  7  7  7  4  4  7  7  7  7  4  4  4  4   4
7   4  4  6  9  6  4  4  7  9  9  7  4  4  4  9   59
6   4  4  6  9  6  4  4  7  9  6  4  4  4  4  9   59
6   4  4  6  9  6  4  4  7  9  9  7  4  4  7  9   59
6   4  4  6  9  6  4  4  7  9  6  4  4  4  7  9   59
6   4  4  6  9  6  4  4  7  9  9  6  4  4  7  9   9
6   4  4  6  9  6  4  4  7  9  9  6  4  4  7  9   9
6   4  4  7  7  7  4  4  7  6  6  7  4  4  7  9   9
6   4  4  4  4  4  4  4  4  4  4  4  4  4  7  9   9
7   6  7  7  6  7  6  6  7  6  7  6  7  7  7  9   9