17 32
9 15
9   9  9  9  9   9  9  9  9  9  7  7   7  6  7  9   9 
9   9  9  9  9   9  9  9  9  9  7  4   4  4  7  9   9
9   9  9  9  9   9  9  9  9  9  6  4   4  4  7  9   9
9   9  9  9  9   9  9  9  9  9  7  4   4  4  7  9   9
9   9  9  9  9   9  9  9  9  9  54 4   4  4  7  9   9
9   9  9  9  9   7  7  6  7  6  7  4   4  4  7  9   9
9   9  9  9  9   7  4  4  4  4  4  4   4  4  7  9   9
9   9  9  9  9   6  4  4  4  4  4  4   4  4  7  9   9
9   9  9  9  9   7  4  4  4  4  4  4   4  4  7  9   9
9   9  9  9  9   7  7  6  7  6  7  4   4  4  7  9   9
9   9  9  9  9   9  9  9  9  9  7  4   4  4  6  9   9
9   9  9  9  9   9  9  9  9  9  6  4   4  4  7  9   9
9   9  9  9  9   9  9  9  9  9  7  4   4  4  7  9   9
9   9  9  9  9   9  9  9  9  9  7  4   4  4  7  9   9
9   9  9  9  9   9  9  9  9  9  7  4   4  4  9  45  9
9   9  9  9  9   9  9  9  9  9  7  4   4  4  9  44  9
9   9  9  9  9   9  9  9  9  9  6  4   4  4  9  44  9
9   9  9  9  9   9  9  9  9  9  7  4   4  4  4  4   9
9   9  9  9  9   9  9  9  9  9  7  4   4  4  4  4   9
9   9  9  9  9   9  9  9  9  9  6  4   4  4  4  4   9
9   9  9  9  9   7  7  54 54 54 7  4   4  4  9  44  9
9   9  9  9  9   7  4  4  4  4  4  4   4  4  9  44  9
9   9  9  9  9   6  4  4  4  4  4  4   4  4  9  44  9
9   9  9  9  9   7  4  4  4  4  4  4   4  4  7  44  9
9   9  9  9  9   7  7  7  7  7  7  4   4  4  6  44  9
9   9  9  9  9   9  9  9  9  9  6  4   4  4  7  44  9
9   9  9  9  9   9  9  9  9  9  7  4   4  4  6  44  9
9   9  9  9  9   9  9  9  9  9  6  4   4  4  7  45  9
9   9  9  9  9   7  7  7  7  7  7  4   4  4  7  9   9
9   9  9  9  9   6  4  4  4  4  4  4   4  4  7  9   9
9   9  9  9  9   7  4  4  4  4  4  4   4  4  7  9   9
9   9  9  9  9   7  7  7  7  7  7  7   7  7  7  9   9
