32 11
0 0 
7 7 5 7 7 7 7 7 5 7 7 5 7 7 7 7 7 7 7 7 5 7 5 7 7 7 5 7 5 7 5 7
0 8 8 8 8 8 8 8 8 8 8 8 8 8 8 8 8 8 8 8 8 8 8 8 8 8 8 8 8 8 8 0
0 8 8 8 8 8 8 8 8 8 8 8 8 8 8 8 8 8 8 8 8 8 8 8 8 8 8 8 8 8 8 0
7 7 6 7 7 8 7 8 7 7 7 6 7 4 4 4 4 4 7 7 6 7 6 7 8 7 6 7 6 7 6 7
9 9 9 9 7 6 7 6 7 9 9 9 7 4 4 4 4 4 0 9 9 9 9 7 6 7 9 9 9 9 9 9
9 9 9 9 9 9 9 9 9 9 9 9 7 4 4 4 4 4 0 9 9 9 9 9 9 9 9 9 9 9 9 9
9 9 9 9 9 9 9 9 9 9 9 9 7 4 4 4 4 4 0 9 9 9 9 9 9 9 9 9 9 9 9 9
7 5 7 7 7 7 5 7 5 7 7 5 7 4 4 4 4 4 7 5 7 7 7 7 5 7 5 7 7 7 5 7
7 8 8 8 8 8 8 8 8 8 8 8 8 8 8 8 8 8 8 8 8 8 8 8 8 8 8 8 8 8 8 0
7 8 8 8 8 8 8 8 8 8 8 8 8 8 8 8 8 8 8 8 8 8 8 8 8 8 8 8 8 8 8 0
7 0 0 7 7 7 7 7 7 7 7 7 7 7 0 0 0 7 7 7 7 7 7 7 7 7 7 7 7 7 7 7