17 32
9 15
7   6  7  7  6   7  7  6  7  7  6  7  7  7  7  7   7 
6   4  4  4  4   4  4  4  4  4  4  6  9  9  9  9   7
7   4  4  7  7   7  7  7  7  4  4  7  9  9  9  9   7
7   4  4  6  9   9  9  9  6  4  4  6  9  9  9  9   7
6   4  4  7  9   9  9  9  7  4  4  7  9  9  9  9   7
7   4  4  6  9   9  9  9  41 4  4  6  9  9  9  9   7
6   4  4  7  9   9  9  9  6  4  4  7  9  9  9  9   7
7   4  4  6  9   9  9  9  7  4  4  6  9  9  9  9   7
6   4  4  7  9   9  9  9  6  4  4  7  9  9  9  9   7
7   4  4  6  9   9  9  9  7  4  4  6  9  9  9  9   7
6   4  4  7  9   9  9  9  6  4  4  7  9  9  9  9   7
7   4  4  6  9   9  9  9  7  4  4  7  9  9  9  9   7
6   4  4  7  9   9  9  9  6  4  4  6  9  9  9  9   7
7   4  4  6  9   9  9  9  7  4  4  7  9  9  9  9   7
6   4  4  6  9   52 52 52 7  4  4  4  60 9  9  9   7
7   4  4  7  7   4  4  4  4  4  4  4  59 9  9  9   7
6   4  4  4  4   4  4  4  4  4  4  4  59 9  9  9   7
6   4  4  7  7   7  7  7  7  4  4  4  59 9  9  9   7
7   4  4  7  9   9  9  6  4  4  4  4  59 9  9  9   7
7   4  4  7  9   9  9  7  7  4  4  4  4  7  7  7   7
6   4  4  7  9   9  9  6  4  4  4  4  4  4  4  4   7
7   4  4  7  9   9  9  9  7  4  4  4  4  4  4  4   7
7   4  4  7  9   9  9  9  7  4  4  4  4  4  4  4   7
7   4  4  7  9   9  9  9  7  4  4  7  7  7  4  4   7
7   4  4  7  9   9  9  9  7  4  4  6  9  7  4  4   7
6   4  4  7  9   9  9  9  6  4  4  7  9  7  4  4   7
7   4  4  7  9   9  9  9  7  4  4  7  9  7  44 55  7
7   4  4  7  9   9  9  9  6  4  4  7  9  7  44 55  7
6   4  4  7  7   7  7  7  7  4  4  6  9  7  45 56  7
7   4  4  4  4   4  4  4  4  4  4  7  9  7  9  9   7
7   4  4  4  4   4  4  4  4  4  4  4  6  7  9  9   7
7   7  7  6  7   7  6  7  6  7  6  7  7  7  7  7   7