17 32
9 15
9   9  9  9  9   9    9    9    9  9    7    7   7  204  7    9   9 
9   9  9  9  9   9    9    9    9  9    7    4   4  4    7    9   9
9   9  9  9  9   9    9    9    9  9    193  4   4  4    7    9   9
9   9  9  9  9   9    9    9    9  9    54   4   4  4    7    9   9
9   9  9  9  9   7    7    202  7  203  7    4   4  4    7    9   9
9   9  9  9  9   7    4    4    4  4    4    4   4  4    7    9   9
9   9  9  9  9   7    199  200  7  201  7    4   4  4    7    9   9
9   9  9  9  9   9    9    9    9  9    7    4   4  4    7    9   9
9   9  9  9  9   9    9    9    9  9    7    4   4  4    196  9   9
9   9  9  9  9   9    9    9    9  9    192  4   4  4    7    9   9
9   9  9  9  9   9    9    9    9  9    7    4   4  4    7    9   9
9   9  9  9  9   9    9    9    9  9    7    4   4  4    7    45  9
9   9  9  9  9   9    9    9    9  9    7    4   4  4    9    44  9
9   9  9  9  9   9    9    9    9  9    7    4   4  4    9    44  9
9   9  9  9  9   9    9    9    9  9    191  4   4  4    9    4   9
9   9  9  9  9   9    9    9    9  9    7    4   4  4    4    4   9
9   9  9  9  9   9    9    9    9  9    7    4   4  4    4    4   9
9   9  9  9  9   9    9    9    9  9    190  4   4  4    4    44  9
9   9  9  9  9   7    7    54   54 54   7    4   4  4    9    44  9
9   9  9  9  9   7    4    4    4  4    4    4   4  4    9    44  9
9   9  9  9  9   189  4    4    4  4    4    4   4  4    9    44  9
9   9  9  9  9   7    4    4    4  4    4    4   4  4    7    7   9
9   9  9  9  9   7    7    7    7  7    7    4   4  4    195  7   9
9   9  9  9  9   9    9    9    9  9    188  4   4  4    7    7   9
9   9  9  9  9   9    9    9    9  9    7    4   4  4    194  7   9
9   9  9  9  9   9    9    9    9  9    187  4   4  4    7    7   9
9   9  9  9  9   7    7    197  7  198  7    4   4  4    7    7   9
9   9  9  9  9   186  4    4    4  4    4    4   4  4    7    7   9
9   9  9  9  9   7    4    4    4  4    4    4   4  4    7    7   9
9   9  9  9  9   7    7    7    7  7    7    4   4  4    7    7   9
9   9  9  9  9   9    9    9    9  9    185  4   4  4    7    7   9
9   9  9  9  9   9    9    9    9  9    7    7   7  196  7    7   9
