17 32
9 15
7   7  7  7  7   7  9  9  9  9  9  7   7  7  7  7  7 
17  8  8  8  8  27  9  9  9  9  9  35  8  8  8  8   7
7   8  8  8  8   7  9  9  9  9  9  7   8  8  8  8   7
16  8  8  8  8  26  9  9  9  9  9  7   8  8  8  8   7
7   8  8  8  8   7  9  9  9  9  9  7   8  8  8  8   7
15  8  8  8  8  25  9  9  9  9  9  34  8  8  8  8   7
7   8  8  8  8   7  9  9  9  9  9  7   8  8  8  8   7
7   8  8  8  8  24  9  9  9  9  9  33  8  8  8  8   7
7   8  8  8  8   7  9  9  9  9  9  7   8  8  8  8   7
14  8  8  8  8  23  9  9  9  9  9  7   8  8  8  8   7
7   8  8  8  8   7  9  9  9  9  9  7   8  8  8  8   7
13  8  8  8  8  22  9  9  9  9  9  7   8  8  8  8   7
7   8  8  8  8   7  9  9  9  9  9  32  8  8  8  8   7
7   8  8  8  8   7  7  52 52 52 7  7   8  8  8  8   7
7   8  8  8  8   4  4  0  0  4  4  4   8  8  8  8   7
7   8  8  8  8   4  0  4  4  0  4  4   8  7  7  7   7
7   8  8  8  8   4  4  4  0  4  4  4   8  8  8  8   7
7   8  8  8  8   4  4  0  4  4  4  4   8  8  8  8   7
7   8  8  8  8   4  0  0  0  0  4  4   8  8  8  8   7
7   8  8  8  8   7  7  7  7  7  7  7   8  8  8  8   7
12  8  8  8  8  21  9  9  9  9  9  31  8  8  8  8   7
7   8  8  8  8   7  9  9  9  9  9  7   8  8  8  8   7
7   8  8  8  8   7  9  9  9  9  9  7   8  7  8  8   7
11  8  8  8  8   7  7  9  9  9  9  30  8  7  8  8   7
7   8  8  8  8   8 20  9  9  9  9  7   8  7  8  8   7
7   8  8  8  8   7  7  9  9  9  9  29  8  7  44 55  7
7   8  8  8  8   8 19  9  9  9  9  7   8  7  44 55  7
7   8  8  8  8   7  7  9  9  9  9  7   8  7  45 56  7
7   8  8  8  8   7  9  9  9  9  9  7   8  7  7  7   7
10  8  8  8  8  18  9  9  9  9  9  7   8  7  7  7   7
7   8  8  8  8   7  9  9  9  9  9  28  8  7  7  7   7
7   7  7  7  7   7  9  9  9  9  9  7   7  7  7  7   7